Humble Start

###########
#........H#
#.........#
 #.......#
 #...#
 #.#.#
 #...#
#P...P#
#######