The Two Paths

############
#....H.....#
######...###
######...###
######.#.###
######.#.###
#####..#..##
####...#...#
####...#...#
####...#...#
####...#...#
#..........#
#..........#
#P........P#
############